+-+-+-+-+-+
| | | | | |
+ +-+ +-+ +
| | | | | |
+ +-+-+ + +
| |   | | |
+-+-+-+-+-+
